#####################
#P  O            O P#
# # # # # # # # # # #
#                   #
# # # # # # # # # # #
#                   #
# # # #  G G  # # # #
#       G   G       #
# # # #       # # # #
#                   #
# # # # # # # # # # #
#                   #
# # # # # # # # # # #
#P  O            O P#
#####################