#####################
#P                 P#
# # # # # # # # # # #
#                   #
# # # # # # # # # # #
#                   #
# # # #  G G  # # # #
#       G   G       #
# # # #       # # # #
#                   #
# # # # # # # # # # #
#                   #
# # # # # # # # # # #
#P                 P#
#####################