#####################
#P        #        P#
# ### ### # ### ### #
#  O              O #
# # ##### # ##### # #
#   #     #     #   #
### # ### # ### # ###
#       GG GG       #
### # ### # ### # ###
#   #     #     #   #
# # ##### # ##### # #
#  O              O #
# ### ### # ### ### #
#P        #        P#
#####################