###############
#P     #     P#
# ### ### ### #
#             #
# ## G G ## # #
#             #
# ## # # ## # #
#             #
# ### ### ### #
#P     #     P#
###############