###############
#P  O  #  O  P#
# ### ### ### #
#             #
# ## G G ## # #
#             #
# ## # # ## # #
#             #
# ### ### ### #
#P  O  #  O  P#
###############